Ambassador|CHA|CHA|
Scholar|INT|INT|
Professional|INT|CHA|
Ninja|INT|SPE|
Daredevil|SPE|TGH|
Infiltrator|SPE|SPE|
Rogue|SPE|CHA|
Investigator|SPI|CHA|
Acolyte|SPI|INT|
Explorer|SPI|SPE|
Cleric|SPI|SPI|
Dreadnought|STR|TGH|
Paladin|STR|SPI|
Duelist|STR|SPE|
Berserker|STR|STR|
Hero|STR|CHA|
Corsair|STR|INT|
Knight|TGH|CHA|
Stalwart|TGH|SPI|
Bodyguard|TGH|TGH|
Wanderer|TGH|INT|
Libertine|LST|SPE|
Vigilante|LST|SPI|
Courtesan|LST|CHA|
Masochist|LST|TGH|
Crusader|LST|INT|
Sadist|LST|STR|
Pirate|CRP|SPE|
Warlord|CRP|STR|
Politician|CRP|CHA|
Tyrant|CRP|TGH|
Aristocrat|CRP|INT|
Templar|CRP|SPI|
Artist|LST|LST|
Terrorist|LST|CRP|
Sociopath|CRP|CRP|